{
    "0": [
        { "t": 0, "x": 0, "y": 0 },
        { "t": 0, "x": 1, "y": 0 },
        { "t": 0, "x": 2, "y": 0 },
        { "t": 0, "x": 3, "y": 0 },

        { "t": 0, "x": 0, "y": 1 },
        { "t": 0, "x": 1, "y": 1 },
        { "t": 0, "x": 2, "y": 1 },
        { "t": 0, "x": 3, "y": 1 },
        
        { "t": 0, "x": 0, "y": 2 },
        { "t": 0, "x": 1, "y": 2 },
        { "t": 0, "x": 2, "y": 2 },
        { "t": 0, "x": 3, "y": 2 },

        { "t": 0, "x": 0, "y": 3 },
        { "t": 0, "x": 1, "y": 3 },
        { "t": 0, "x": 2, "y": 3 },
        { "t": 0, "x": 3, "y": 3 }
    ]
}